___________________
|........|........|
|*/\./-\.|./-\./\*|
|.\/.\-/.|.\-/.\/.|
|.................|
|.__.|._____.|.--.|
|....|...|...|....|
----.---.|.---.----
   |.|.......|.|   
----.|.__ __.|.----
    ...|   |...    
----.|.-----.|.----
   |.|.......|.|
----.|._____.|.----
|........|........|
|.__.___.|.___.__.|
|..|...........|..|
|-.|.|._____.|.|.-|
|....|...|...|....|
|.------.|.------.|
|.................|
___________________